? ?
0 1
EPPPPPPPPPPPPPPPPP
WWWWWWWWWWWWWWWWWP
PPPPPPPPPPPPPPPPWP
PPPPPPPPPPPPPPPPWP
PPPPPPPPPPPPPPPPWP
PPPPPPPPPPPPPPPPWP
PPPPPPPPPPPPPPPPWP
PPPPPPPPPPPPPPPPWP
PPPPPPPPPPPPPPPPWP
PPPPPPPPPPPPPPPPWP
PPPPPPPPPPPPPPPPWP
PPPPPPPPPPPPPPPPWP
PPPPPPPPPPPPPPPPWP
PPPPPPPPPPPPPPPPWP
PPPPPPPPPPPPPPPPWP
PPPPPPPPPPPPPPPPWP
PPPPPPPPPPPPPPPPWP
PPPPPPPPPPPPPPPPWP
PPPPPPPPPPPPPPPPWP
PPPPPPPPPPPPPPPPWP
PPPPPPPPPPPPPPPPPP